%%%%%%%%
%P     %
%  %   %
%  %   %
%  % . %
%  o   %
%%%%%%%%