%%%%%%%
%.   .%
%     %
%     %
%     %
%P    %
%%%%%%%