%%%%%%%%%%
%        %
%  ..    %
%        %
%     P  %
%        %
%%%%%%%%%%