%%%%%%%%
%P    .%
% %%   %
%  %   %
%.    .%
%  .   %
%%%%%%%%