%%%%%%%%%%
%       P%
%  .     %
%        %
%  .     %
%        %
%%%%%%%%%%