%%%%%%%%%%%
%.       .%
%         %
%         %
%         %
%    P    %
%%%%%%%%%%%