%%%%%%%%%%%
%.       .%
%         %
%         %
%         %
%      P  %
%%%%%%%%%%%