%%%%%%%%%
%.     .%
%       %
%       %
%       %
%       %
%       %
%   P   %
%%%%%%%%%