%%%%%%%%%%%
%.       .%
%         %
%         %
%         %
%   P     %
%%%%%%%%%%%