%%%%%%%%%%
%  .     %
%        %
%  P     %
%  .     %
%        %
%%%%%%%%%%