%%%%%%%%%%%
%        .%
%         %
%         %
%         %
%.   P    %
%%%%%%%%%%%