%%%%%%%%%%
%.       %
%  .     %
%        %
%        %
%  P     %
%%%%%%%%%%