%%%%%%%%%%%%%%%%
%    .   .   . %
%              %
%.             %
%           .  %
%   P          %
%%%%%%%%%%%%%%%%