%%%%%%%%%%
%.      .%
%        %
%        %
%        %
%   P    %
%%%%%%%%%%