%%%%%%%%%%
%        %
%  .     %
%.       %
%      P %
%        %
%%%%%%%%%%