%%%%%%%%%%%%%%%%
%   .    .   . %
%              %
%.             %
%              %
%   P        . %
%%%%%%%%%%%%%%%%