%%%%%%%%%%%%%%%%%
%.             .%
%               %
%               %
%               %
%               %
%               %
%               %
%               %
%               %
%               %
%               %
%               %
%               %
%               %
%       P       %
%%%%%%%%%%%%%%%%%