%%%%%%%%%%%
%        .%
%         %
%         %
%.        %
%    P    %
%%%%%%%%%%%