%%%%%%%%%%%
%.        %
%         %
%        .%
%         %
%    P    %
%%%%%%%%%%%