%%%%%%%%%%%%%%%%%
%.           .  %
%               %
%               %
%               %
%               %
%               %
%               %
%               %
%               %
%               %
%               %
%               %
%               %
%               %
%      P        %
%%%%%%%%%%%%%%%%%