%%%%%%%%
%P    .%
%  %   %
%  %   %
%  % . %
%  .   %
%%%%%%%%