%%%%%%%%%
%.  .   %
%       %
%       %
%       %
%       %
%       %
%  P    %
%%%%%%%%%