%%%%%%%%%%
%    . P %
%        %
%     .  %
%        %
%        %
%%%%%%%%%%