%%%%%%%%%%
%     .  %
%        %
%    P   %
%        %
%.       %
%%%%%%%%%%