%%%%%%%%%%
% .      %
%        %
% P      %
% .      %
%        %
%%%%%%%%%%