%%%%%%%%%%%
%.     .  %
%         %
%         %
%         %
%    P    %
%%%%%%%%%%%