%%%%%%%%%%
%        %
%  .     %
%.       %
%     P  %
%        %
%%%%%%%%%%