%%%%%%%%%
%      .%
%       %
%.      %
%       %
%       %
%       %
%   P   %
%%%%%%%%%