%%%%%%%%%
%   .  .%
%       %
%.      %
%       %
%       %
%       %
%   P   %
%%%%%%%%%