%%%%%%%%%%
%.       %
% P      %
%.       %
%        %
%        %
%%%%%%%%%%