%%%%%%%%%%%
%        .%
%         %
%.        %
%         %
%    P    %
%%%%%%%%%%%