%%%%%%%%%%%
%  .     .%
%         %
%         %
%         %
%    P    %
%%%%%%%%%%%