%%%%%%%%%%%%%%%%
%.           . %
%              %
%              %
%              %
%      P       %
%%%%%%%%%%%%%%%%