%%%%%%%%%%
%        %
%        %
%  . P.  %
%        %
%        %
%%%%%%%%%%