%%%%%%%%%%
%  .     %
%P       %
%   .    %
%        %
%        %
%%%%%%%%%%