%%%%%%%%%%%%%%%%%
%.           .  %
%               %
%               %
%               %
%               %
%               %
%               %
%               %
%               %
%               %
%               %
%               %
%               %
%               %
%P              %
%%%%%%%%%%%%%%%%%