%%%%%%%%%%
%        %
%     .P %
%        %
%        %
%    .   %
%%%%%%%%%%