%%%%%%%%%%
%        %
%     .  %
%       .%
%    P   %
%        %
%%%%%%%%%%