%%%%%%%%%%
%.       %
%   .    %
%        %
%     P  %
%        %
%%%%%%%%%%