%%%%%%%%%%
%.      .%
%   %    %
%  %%%   %
%        %
%   P    %
%%%%%%%%%%