%%%%%%%%%%%
%        .%
%         %
%   .     %
%         %
%    P    %
%%%%%%%%%%%