%%%%%%%%
%P    .%
% %%   %
%  %   %
%  % . %
%  .   %
%%%%%%%%