%%%%%%%%%%%
%.        %
%         %
%      .  %
%         %
%    P    %
%%%%%%%%%%%