%%%%%%%%%%
%        %
%..      %
%        %
%        %
%   P    %
%%%%%%%%%%