%%%%%%%%%%%%%%%%
%   .    .   . %
%    %         %
%.  %%%%%   %  %
%    %%%%   %  %
%   P       %. %
%%%%%%%%%%%%%%%%